S S S S S S S S S S S S S S S S
S S S S S S S S S S S S S S S S
S B B B B B B B B B B B B S S S
S X X X X X X X X X X X X B B S
S X X X X X X X X X X X X X X S
S X X X X X X X X X X X X X X S
S S S S S S S S S S S S S X X S
X X X X X X X X X X X X X X X S
X X X X X X X X X X X X X X X S
X X X X X X X X X X X X X X X S
X X X X X X X X X X X X X X X S
X X X X X X X X X X X X X X X X
X X X X X X X X X X X X X X X X
X X X X X X X X X X X X X X X X
X X X X X X X X X X X X X X X X
X X X X X X X X X X X X X X X X