S S S S S S S S S S S S S S S S
S S S S S S S S S S S S S S S S
S S S S B B B B B B B B B S S S
S B B B B X XBCA X X XC X X S S S S
S SDC X X X X X X X X X X X X S S
S S X X X X X X X X X X X X S S
S S X X X S B B B B X X X X S S
S S B B B S S XBCA XB XB X X X X S S
S S X X X X X X X X X X X X S S
S S X X X X X X X X X X X X S S
S S XBCD X X B B B B B B B B B S S
S S X X X X X X X X X X X X S S
S S X X X X X X X X X X X X S S
S S B B B B B B B B X X X X S S
S S B X X X X X X X X X X X S S
X X X S X X X X X X X X X X X X